

######################################################
#                                                    #
#                                                    #
#                                        #           #
########                                             #
#                                                    #
#              #                                     #
#                                                    #
#                                      #             #
###                                                  #
#                                                    #
#                                                    #
#                                                    #
#                                                    #
#      ####                                          #
#                               #                    #
#                 #                                  #
#                                                    #
#                    #                               #
#                #                                   #
#                                                    #
#                                                    #
#                                                    #
#  #  #      #                      #                #
#                                                    #
#                 #             #                    #
#                                                    #
#                                                    #
######################################################

