######################################################
#                                                    #
#                                                    #
#             #                       #              #
#   ##                                               #
#                            #        #              #
#        #########                                   #
#                                                    #
#                                                    #
#                                                    #
#                       ######        ###"           #
#                    ###                             #
#                  ##                                #
#     #                                              #
#                                                    #
#                                                    #
#                                                    #
#                                                    #
######################################################
